28 Þubat askeri deðil ekonomik operasyondu

Can Ataklý - catakli@gazetevatan.com

Bugün 28 Þubat. 15 yýl önce bugün yapýlan bir Milli Güvenlik Kurulu toplantýsýnda alýnan kararlarla anýlan bir sürece bu ismi takmýþtýk. 28 Þubat süreci 15 yýl geçmesine raðmen hâlâ þiddetle tartýþýlýyor.

- YANLIÞ TARTIÞMA: Ancak özellikle bugünün dinci egemenleri 28 Þubat’ý iþlerine geldiði gibi anlatýyorlar. Kendilerine aydýn diyen maskeliler ise geçmiþin hýncýný çýkarmaya çalýþýyor. Size çok farklý bir 28 Þubat anlatmak istiyorum.

- KÝM YAPTI: 28 Þubat bir askeri darbe gibi algýlanýyor bugün. Gerçi o gün de bu yönde görüþler hâkimdi ama, 28 Þubat askeri bir operasyondan ziyade, büyük sermayenin ekonomik çatýþmasýdýr.

- MERKEZ SAÐ: Özal’ýn ölümünden sonra bütün taþlar yerinden oynamýþtý. Demirel’in Çankaya’ya çýkmasý ile Tansu Çiller adeta yaratýlmýþtý. Merkez sað-sol koalisyonu iktidardaydý.

- GÜMRÜK BÝRLÝÐÝ: Dönemin iktidar ortaðý SHP (sonra CHP oldu) gönülden olmasa da Çiller’li DYP’nin AB hayaline destek veriyordu. Gümrük Birliði’ne bu dönemde girmiþtik.

- SERMAYE RAHATSIZ: O günün büyük sermayesi AB hedefinden rahatsýzdý. Çünkü henüz Avrupa ile rekabet edebilecek düzeye ulaþmadýðýna inanýyordu. Buna þiddetle karþý çýkýyordu.

- REKABET BAHANE: Avrupa ile rekabet edememe gerekçesi görünüþte doðruydu ama büyük sermaye devletten iþ almaya alýþýk olduðundan aslýnda uluslararasý rekabetten kaçýyordu.

- 95 SEÇÝMLERÝ: Gümrük Birliði’ne girdikten hemen sonra gidilen seçimlerde iki merkez sað parti DYP ve ANAP’ýn baþa baþ çýkmasý, ama dinci Refah’ýn birinci olmasý endiþe yaratmýþtý.

- DYP-ANAP: Bu endiþe Çiller’li DYP ile Yýlmaz’lý ANAP’ýn koalisyon kurmasý ile bir parça giderildi. Ancak Mesut Yýlmaz bu koalisyonu fazla sürdüremedi.

- SERMAYE KARÞIYDI: Çünkü büyük sermaye hâlâ AB hedefindeki Çiller’den rahatsýzdý. Çiller ise koalisyonu AB’ye girmek için zorluyordu. Sonunda Yýlmaz hükümeti bozdu.

- REFAHYOL: Koalisyon bozulunca AB’ye “batýl” diyen Refah’ýn ANAP’la koalisyon kurmasý gündeme geldi. Asker ise endiþeliydi. ANAP kontrolü ele alamayabilirdi.

- ÝRTÝCA GELÝR: Yýlmaz’lý bir Refah koalisyonu AB hedefini bir kenara býrakýrdý ama ANAP içindeki dinci unsurlarla birleþecek Refah Partisi ülkeye irtica getirebilirdi.

- ÇÝLLER’E DESTEK: Tam Yýlmaz Erbakan’la koalisyon kuracakken, askerler Çiller’i cesaretlendirerek “Hükümette siz olun, Yýlmaz’a güvenmiyoruz” mesajý ilettiler. Þöyle oldu:

- ULUDAÐ ZÝRVESÝ: O tarihteki Genelkurmay Baþkaný Karadayý Uludað’da tatil yapýyordu. Çiller de Uludað’a gitti. Temsilci olarak Yalým Erez’i Karadayý’ya gönderdi.

- RAHAT EDÝN: Karadayý Erez’e “Hükümette siz olun, ekonomi ve dýþiþlerini mutlaka siz alýn. Biz Refah’a baský yapabiliriz, ama Tansu Çiller sakýn alýnmasýn” dedi.

- YENÝ HÜKÜMET: Askerler ve büyük sermaye Refah’ýn AB yolunu törpüleyeceðine inanýyordu. Bu nedenle REFAHYOL’un kurulmasýna hiç ses etmediler.

- BEKLENMEYEN: Aslýnda hükümetin Çiller Baþkanlýðý’nda kurulacaðý sanýlýyordu. Ama iki parti dönüþümlü baþbakanlýkta anlaþtý. Ýlk baþbakan Erbakan olacaktý.

- RAHATSIZLIK: Erbakan Ýslam dünyasýnda etkili olmak isterken Çiller’in AB hayaline de karþý çýkmadý. Çiller AB çalýþmalarýný sürdürdü. Asker ve sermaye rahatsýz oldu.

- SUSURLUK KAZASI: Hükümetin dönüm noktasý Susurluk kazasýdýr. Ayný gün mini yerel seçimler yapýlmýþ ve DYP büyük baþarý kazanmýþtý. Seçim bir anda arka plana düþtü.

- BAHANE BULUNDU: Avrupa Birliði karþýtý sermaye ve güdümündeki medya Susurluk’u bahane ederek iktidara yüklenmeye baþladý. “Bir dakika karanlýk” eylemleri baþladý.

- ÝRTÝCAYA DÖNÜÞTÜ: Avrupa Birliði’ne açýkça karþý çýkamayanlar Sincan’ý, Baþbakanlýk’taki iftarý bahane ederek eylemi bir anda irtica karþýtý eyleme çevirdiler.

- ASKER DEVREDE: Medyanýn ve büyük sermayenin dayanak noktasý yoktu, bu nedenle asker devreye sokuldu. Medya asker üzerinden iktidara vurmaya baþladý.

- ASKER PÝYONDU: 28 Þubat’ýn asker eylemi olduðu söylense de, askerler aslýnda o dönemin piyonlarýydý. Medya askeri kullanýyordu, asker de ses etmiyordu.

- DÜZMECE HABERLER: O dönemde medya pek çok düzmece habere imza attý. Her haberde asker kiþilere atýf yapýlýyordu, çoðundan askerin haberi bile yoktu. Ama...

- HOÞLARINA GÝTTÝ: Ýktidardan doðal olarak rahatsýz olan asker ise çok gündemde olmaktan hoþnuttu. Darbe dönemlerindeki gibi herkes askerin etrafýnda adeta pervane olmuþtu.

- NELER OLUYORDU: Oysa bu sýrada büyük sermaye de medya da sistem üzerinde egemenlik kurmuþtu. Bankalar leblebi gibi satýlýyor, yolsuzluklara arþýâlâya ulaþýyordu.

- HÜKÜMET YIKILIYOR: Sonunda DYP’ye operasyon yapýldý, bakanlar milletvekilleri tehdit ve þantajlarla birer birer istifa ettirildi. Hükümet ayýplý biçimde düþürüldü.

- AB DURDURULDU: Cumhurbaþkaný Demirel Çiller’i kandýrarak baþbakanlýða Mesut Yýlmaz’ý getirdi. Yýlmaz AB karþýtý partilerden alelacele bir hükümet kurdu.

- YÜRÜMEDÝ: Ancak Yýlmaz hükümeti derme çatma olduðu için yürümedi. Ülke 1999’da tekrar seçime gitti. ANAP ve DYP iyice eridi, DSP- MHP ise güçlendi.

- YENÝ HÜKÜMET: Refah’ýn yerine kurulan Fazilet geriletilmiþti. Ecevit Fazilet ve DYP dýþýndaki partilerle dörtlü koalisyon kurdu. AB ile ilgili çalýþmalar durma noktasýna geldi.

- AB’DEN KOPUÞ: Ecevit hükümetinin en büyük baþarýsý(!) 1999’da AB ile ipleri tamamen koparmak oldu. Lüksemburg toplantýsýnda Türkiye AB’den vazgeçtiðini açýkladý.

- GLOBAL EKONOMÝ: Oysa ayný dönemde dünya artýk Global Ekonomi’nin hâkimiyetine girmiþti. Türkiye’nin bundan kaçmasý da mümkün deðildi. Üstelik Orta Doðu deðiþecekti.

- YENÝ DÜZEN: Türkiye’de AB karþýtlarý asker üzerinden oyun oynarken, Amerika Orta Doðu’da yeni bir düzen kurmaya kararlýydý. Türkiye’deki kadrolar ise yetersizdi.

- ILIMLI ÝSLAM: Amerika Orta Doðu’ya demokrasi getirmek bahanesiyle eyleme baþlarken Türkiye’ye de rol biçilmiþti. Türkiye bölge hâkimiyeti için daha Ýslamcý görünecekti.

- ÝSÝM BELÝRLENÝYOR: Mevcut kadrolarýn bunu yapmasý mümkün deðildi. Ýþte AKP fikri bu dönemde ortaya çýktý. Ýslami özelliðini öne çýkaran bir isim aranmaya baþlandý.

- ERDOÐAN: Bulunan isim Erdoðan’dý. Genç, mücadeleci, belediye baþkanlýðý yapmýþ, hapse girmiþ Erdoðan için Amerika’da yoðun bir kulis yapýldý. Sonunda parti kuruldu.

- AKP KAZANIYOR: Türkiye 2002 seçimlerine bu ortamda gitti. Halk yolsuzluklardan býkmýþtý. AKP yenilikçi olarak ortaya çýkmýþtý, Erbakan tehlikesi de artýk yoktu.

- TEKRAR AB: Yeni dünya düzeni nedeniyle AB karþýtlýðýndan artýk vazgeçen büyük sermaye ve medya yeni iktidara büyük destek verdi. AKP bunu fýrsat bilip AB hedefine sarýldý.

- GERÝSÝ MALUM: Bundan sonrasýný zaten defalarca yazdým. AKP büyük sermaye ile iþbirliðini AB hedefinde buldu. Türkiye yeni ekonomik düzenle büyümeye baþladý.

- SONUÇ: Evet 28 Þubat’ta askerler vardý. Ama asýl büyük oyuncular sivillerdi. AB’yi engelleyerek zaman kazandýlar ve yeniden organize oldular. Uyum saðladýlar.

- MERKEZ BÝTTÝ: Ancak kapitalizmin temsilcisi merkez sað bu arada yok olup gitti. Yerine yine saðda ama daha dinci bir iktidar kuruldu. Çok güçlendi. Dönüþüm baþlattý.

- DEÐÝÞÝMÝ OKUMAK: 28 Þubat sayesinde AKP yaratýldý. AKP deðiþimi iyi okudu ve sisteme hâkim oldu. Ama þimdi dünya yeni bir deðiþimin eþiðinde. AKP ise statükocu oldu.

- DEÐÝÞÝMÝ OKUYAMAMAK: Þimdi deðiþimi okuyamama sýrasý AKP’de. Çok güçlendiklerine inanýyorlar. Ama dünya yeniden deðiþiyor. Bazý geliþmelerin kaynaðý budur.